000 000 000 000 000 000 000 000 000 000 000 000 000 000 000 000 001 002 003 002 002 004 005 002 002 006 007 002 002 008 002 009 000 000 000 000 000 000 000 000 000 000 000 000 000 000 000 000 000 000 000 000 000 000 000 000 000 000 000 000 000 000 000
000 000 000 000 000 000 000 000 000 000 000 000 000 000 000 000 011 012 013 014 015 016 017 018 018 019 020 021 022 023 024 025 000 000 000 000 000 000 000 000 000 000 000 000 000 000 000 000 000 000 000 000 000 000 000 000 000 000 000 000 000 000 000
000 000 000 000 000 000 000 000 000 000 000 000 000 000 000 000 011 028 029 029 029 029 029 029 029 029 029 029 029 029 030 025 000 000 000 000 000 000 000 000 000 000 000 000 000 000 000 000 000 000 000 000 000 000 000 000 000 000 000 000 000 000 000
000 000 000 000 000 000 000 000 000 000 000 000 000 000 000 000 032 033 029 029 029 029 029 104 104 029 029 029 029 029 034 035 000 000 000 000 000 000 000 000 000 000 000 000 000 000 000 000 000 000 000 000 000 000 000 000 000 000 000 000 000 000 000
000 000 000 000 000 000 000 000 000 000 000 000 000 000 000 000 038 047 029 029 029 029 029 044 044 029 029 029 029 029 052 046 000 000 000 000 000 000 000 000 000 000 000 000 000 000 000 000 000 000 000 000 000 000 000 000 000 000 000 000 000 000 000
000 000 000 000 000 000 000 000 000 000 000 000 000 000 000 000 011 047 029 029 029 029 044 029 029 044 029 029 029 029 052 025 000 000 000 000 000 000 000 000 000 000 000 000 000 000 000 000 000 000 000 000 000 000 000 000 000 000 000 000 000 000 000
000 000 000 000 000 000 000 000 000 000 000 000 000 000 000 000 053 047 029 029 029 029 029 044 044 029 029 029 029 029 052 060 000 000 000 000 000 000 000 000 000 000 000 000 000 000 000 000 000 000 000 000 000 000 000 000 000 000 000 000 000 000 000
000 000 000 000 000 000 000 000 000 000 000 000 000 000 000 000 061 062 029 029 029 029 029 104 104 029 029 029 029 029 063 064 000 000 000 000 000 000 000 000 000 000 000 000 000 000 000 000 000 000 000 000 000 000 000 000 000 000 000 000 000 000 000
000 000 000 000 000 000 000 000 000 000 000 000 000 000 000 000 011 054 029 029 029 029 029 029 029 029 029 029 029 029 059 025 000 000 000 000 000 000 000 000 000 000 000 000 000 000 000 000 000 000 000 000 000 000 000 000 000 000 000 000 000 000 000
000 000 000 000 000 000 000 000 000 000 000 000 000 000 000 000 011 067 068 069 070 071 072 092 093 074 075 076 077 078 079 025 000 000 000 000 000 000 000 000 000 000 000 000 000 000 000 000 000 000 000 000 000 000 000 000 000 000 000 000 000 000 000
000 000 000 000 000 000 000 000 000 000 000 000 000 000 000 000 082 083 084 083 083 085 086 091 091 087 088 083 083 089 083 090 000 000 000 000 000 000 000 000 000 000 000 000 000 000 000 000 000 000 000 000 000 000 000 000 000 000 000 000 000 000 000
000 000 000 000 000 000 000 000 000 000 000 000 000 000 000 000 001 002 003 002 002 004 005 010 010 006 007 002 002 008 002 009 000 000 000 000 000 000 000 000 000 000 000 000 000 000 000 000 000 000 000 000 000 000 000 000 000 000 000 000 000 000 000
000 000 000 000 000 000 000 000 000 000 000 000 000 000 000 000 011 012 013 014 015 016 017 026 027 019 020 021 022 023 024 025 000 000 000 000 000 000 000 000 000 000 000 000 000 000 000 000 000 000 000 000 000 000 000 000 000 000 000 000 000 000 000
000 000 000 000 000 000 000 000 000 000 000 000 000 000 000 000 011 028 029 029 029 029 044 029 029 044 029 029 029 029 030 025 000 000 000 000 000 000 000 000 000 000 000 000 000 000 000 000 000 000 000 000 000 000 000 000 000 000 000 000 000 000 000
000 000 000 000 000 000 000 000 000 000 000 000 000 000 000 000 032 033 029 029 044 029 029 029 029 029 029 044 029 029 034 035 000 000 000 000 000 000 000 000 000 000 000 000 000 000 000 000 000 000 000 000 000 000 000 000 000 000 000 000 000 000 000
000 000 000 000 000 000 000 000 000 000 000 000 000 000 000 000 038 047 029 044 029 044 029 029 029 029 044 029 044 029 052 046 000 000 000 000 000 000 000 000 000 000 000 000 000 000 000 000 000 000 000 000 000 000 000 000 000 000 000 000 000 000 000
000 000 000 000 000 000 000 000 000 000 000 000 000 000 000 000 011 047 029 044 029 029 044 029 029 044 029 029 044 029 052 025 000 000 000 000 000 000 000 000 000 000 000 000 000 000 000 000 000 000 000 000 000 000 000 000 000 000 000 000 000 000 000
000 000 000 000 000 000 000 000 000 000 000 000 000 000 000 000 053 047 029 044 029 029 029 044 044 029 029 029 044 029 052 060 000 000 000 000 000 000 000 000 000 000 000 000 000 000 000 000 000 000 000 000 000 000 000 000 000 000 000 000 000 000 000
000 000 000 000 000 000 000 000 000 000 000 000 000 000 000 000 061 062 029 044 029 044 029 029 029 029 044 029 044 029 063 064 000 000 000 000 000 000 000 000 000 000 000 000 000 000 000 000 000 000 000 000 000 000 000 000 000 000 000 000 000 000 000
000 000 000 000 000 000 000 000 000 000 000 000 000 000 000 000 011 054 029 029 029 044 029 029 029 029 044 029 029 029 059 025 000 000 000 000 000 000 000 000 000 000 000 000 000 000 000 000 000 000 000 000 000 000 000 000 000 000 000 000 000 000 000
000 000 000 000 000 000 000 000 000 000 000 000 000 000 000 000 011 067 068 069 070 071 072 092 093 074 075 076 077 078 079 025 000 000 000 000 000 000 000 000 000 000 000 000 000 000 000 000 000 000 000 000 000 000 000 000 000 000 000 000 000 000 000
000 000 000 000 000 000 000 000 000 000 000 000 000 000 000 000 082 083 084 083 083 085 086 091 091 087 088 083 083 089 083 090 000 000 000 000 000 000 000 000 000 000 000 000 000 000 000 000 000 000 000 000 000 000 000 000 000 000 000 000 000 000 000
001 002 003 002 002 004 005 002 002 006 007 002 002 008 002 009 001 002 003 002 002 004 005 010 010 006 007 002 002 008 002 009 001 002 003 002 002 004 005 002 002 006 007 002 002 008 002 009 001 002 003 002 002 004 005 002 002 006 007 002 002 008 002
011 012 013 014 015 016 017 018 018 019 020 021 022 023 024 025 011 012 013 014 015 016 017 026 027 019 020 021 022 023 024 025 011 012 013 014 015 016 017 018 018 019 020 021 022 023 024 025 011 012 013 014 015 016 017 018 018 019 020 021 022 023 024
011 028 029 029 029 029 029 029 029 029 029 029 029 029 030 025 011 028 029 029 029 029 029 029 029 029 029 029 029 029 030 025 011 028 029 029 029 029 044 029 029 029 029 044 029 029 030 025 011 028 029 029 029 029 029 029 029 029 029 029 029 029 030
032 033 029 029 029 029 029 029 029 029 029 029 029 029 034 035 032 033 029 029 029 029 029 029 029 029 029 029 029 029 034 035 032 033 029 029 029 044 029 029 029 029 044 029 029 029 034 035 032 033 029 029 029 029 029 029 029 029 029 029 029 029 034
038 047 029 029 044 029 029 029 029 029 029 044 029 029 040 041 042 043 029 029 029 044 044 044 044 044 029 029 029 029 040 041 042 043 029 029 029 044 029 029 029 029 044 029 029 029 040 041 042 043 029 029 029 029 029 029 029 044 029 029 029 029 052
011 047 029 029 029 029 029 029 029 029 029 029 029 029 048 049 050 051 029 029 044 044 044 029 029 044 044 029 029 029 101 049 050 051 029 029 029 044 029 029 029 029 044 029 029 029 048 049 050 100 029 029 029 029 029 029 044 029 029 029 029 029 052
053 047 029 029 044 029 029 029 029 029 029 044 029 029 055 056 057 058 029 044 044 044 029 029 029 029 044 044 029 029 055 056 057 058 029 029 029 044 029 029 029 029 044 029 029 029 055 056 057 058 029 029 029 029 029 029 029 044 029 029 029 029 052
061 062 029 029 029 029 029 029 029 029 029 029 029 029 063 064 061 062 044 044 044 029 029 029 029 029 029 044 029 029 063 064 061 062 029 029 029 044 029 029 029 029 044 029 029 029 063 064 061 062 029 029 029 029 029 029 029 029 029 029 029 029 063
011 054 029 029 029 029 029 029 029 029 029 029 029 029 059 025 011 054 044 044 029 029 029 029 029 029 029 029 029 029 059 025 011 054 029 029 044 029 029 029 029 044 029 029 029 029 059 025 011 054 029 029 029 029 029 029 029 029 029 029 029 029 059
011 067 068 069 070 071 072 073 073 074 075 076 077 078 079 025 011 067 068 069 070 071 072 080 081 074 075 076 077 078 079 025 011 067 068 069 070 071 072 073 073 074 075 076 077 078 079 025 011 067 068 069 070 071 072 073 073 074 075 076 077 078 079
082 083 084 083 083 085 086 083 083 087 088 083 083 089 083 090 082 083 084 083 083 085 086 091 091 087 088 083 083 089 083 090 082 083 084 083 083 085 086 083 083 087 088 083 083 089 083 090 082 083 084 083 083 085 086 083 083 087 088 083 083 089 083
001 002 003 002 002 004 005 002 002 006 007 002 002 008 002 009 001 002 003 002 002 004 005 010 010 006 007 002 002 008 002 009 001 002 003 002 002 004 005 002 002 006 007 002 002 008 002 009 000 000 000 000 000 000 000 000 000 000 000 000 000 000 000
011 012 013 014 015 016 017 018 018 019 020 021 022 023 024 025 011 012 013 014 015 016 017 026 027 019 020 021 022 023 024 025 011 012 013 014 015 016 017 018 018 019 020 021 022 023 024 025 000 000 000 000 000 000 000 000 000 000 000 000 000 000 000
011 028 029 029 029 029 029 044 044 029 029 029 029 029 030 025 011 028 029 029 029 029 044 029 029 029 044 029 029 029 030 025 011 028 044 029 044 029 044 029 044 029 044 029 044 029 030 025 000 000 000 000 000 000 000 000 000 000 000 000 000 000 000
032 033 029 029 029 029 029 044 044 029 029 029 029 029 034 035 032 033 029 029 029 044 029 029 029 044 029 029 029 029 034 035 032 033 029 044 029 044 029 044 029 044 029 044 029 044 034 035 000 000 000 000 000 000 000 000 000 000 000 000 000 000 000
038 047 029 029 044 044 029 029 029 029 044 044 029 029 040 041 042 043 044 029 044 044 044 029 029 029 044 029 029 029 040 041 042 043 044 029 044 029 044 029 044 029 044 029 044 029 052 046 000 000 000 000 000 000 000 000 000 000 000 000 000 000 000
011 047 029 029 029 029 029 029 029 029 029 029 029 029 048 049 050 051 029 044 044 044 044 103 104 044 044 044 044 029 048 049 050 051 029 044 029 044 029 044 029 044 029 044 029 044 052 025 000 000 000 000 000 000 000 000 000 000 000 000 000 000 000
053 047 029 029 044 044 029 029 029 029 044 044 029 029 055 056 057 058 029 029 044 029 029 029 029 044 044 044 029 044 055 056 057 058 044 029 044 029 044 029 044 029 044 029 044 029 052 060 000 000 000 000 000 000 000 000 000 000 000 000 000 000 000
061 062 029 029 029 029 029 044 044 029 029 029 029 029 063 064 061 062 029 029 029 044 029 029 029 029 044 029 029 029 063 064 061 062 029 044 029 044 029 044 029 044 029 044 029 044 063 064 000 000 000 000 000 000 000 000 000 000 000 000 000 000 000
011 054 029 029 029 029 029 044 044 029 029 029 029 029 059 025 011 054 029 029 044 029 029 029 029 044 029 029 029 029 059 025 011 054 044 029 044 029 044 029 029 029 044 029 044 029 059 025 000 000 000 000 000 000 000 000 000 000 000 000 000 000 000
011 067 068 069 070 071 072 073 073 074 075 076 077 078 079 025 011 067 068 069 070 071 072 092 093 074 075 076 077 078 079 025 011 067 068 069 070 071 072 092 093 074 075 076 077 078 079 025 000 000 000 000 000 000 000 000 000 000 000 000 000 000 000
082 083 084 083 083 085 086 083 083 087 088 083 083 089 083 090 082 083 084 083 083 085 086 091 091 087 088 083 083 089 083 090 082 083 084 083 083 085 086 091 091 087 088 083 083 089 083 090 000 000 000 000 000 000 000 000 000 000 000 000 000 000 000
000 000 000 000 000 000 000 000 000 000 000 000 000 000 000 000 001 002 003 002 002 004 005 010 010 006 007 002 002 008 002 009 001 002 003 002 002 004 005 010 010 006 007 002 002 008 002 009 001 002 003 002 002 004 005 002 002 006 007 002 002 008 002
000 000 000 000 000 000 000 000 000 000 000 000 000 000 000 000 011 012 013 014 015 016 017 026 027 019 020 021 022 023 024 025 011 012 013 014 015 016 017 026 027 019 020 021 022 023 024 025 011 012 013 014 015 016 017 018 018 019 020 021 022 023 024
000 000 000 000 000 000 000 000 000 000 000 000 000 000 000 000 011 028 029 029 029 029 029 029 029 029 029 029 029 029 030 025 011 028 029 029 029 029 029 029 029 029 029 029 029 029 030 025 011 028 029 029 029 029 029 029 029 029 029 029 029 029 030
000 000 000 000 000 000 000 000 000 000 000 000 000 000 000 000 032 033 029 044 029 029 029 029 029 029 029 029 044 029 034 035 032 033 029 029 029 029 029 029 029 029 029 029 029 029 034 035 032 033 029 044 044 044 044 029 029 044 044 044 044 029 034
000 000 000 000 000 000 000 000 000 000 000 000 000 000 000 000 038 047 029 029 029 029 029 029 029 029 029 029 029 029 052 046 038 047 029 029 029 029 029 029 029 029 029 029 029 029 040 041 042 043 029 044 029 029 029 029 029 029 029 029 044 029 052
000 000 000 000 000 000 000 000 000 000 000 000 000 000 000 000 011 047 029 029 029 044 044 044 044 044 044 029 029 029 052 025 011 047 029 029 029 029 029 029 029 029 029 029 029 029 048 049 050 051 029 044 029 036 029 029 029 029 037 029 044 029 052
000 000 000 000 000 000 000 000 000 000 000 000 000 000 000 000 053 047 029 029 029 029 029 029 029 029 029 029 029 029 052 060 053 047 029 029 029 029 029 029 029 029 029 029 029 029 055 056 057 058 029 044 029 029 036 029 029 037 029 029 044 029 052
000 000 000 000 000 000 000 000 000 000 000 000 000 000 000 000 061 062 029 044 029 029 029 029 029 029 029 029 044 029 063 064 061 062 029 029 029 029 029 029 029 029 029 029 029 029 063 064 061 062 029 044 044 044 044 044 044 044 044 044 044 029 063
000 000 000 000 000 000 000 000 000 000 000 000 000 000 000 000 011 054 029 029 029 029 029 029 029 029 029 029 029 029 059 025 011 054 029 029 029 029 029 029 029 029 029 029 029 029 059 025 011 054 029 029 029 029 029 029 029 029 029 029 029 029 059
000 000 000 000 000 000 000 000 000 000 000 000 000 000 000 000 011 067 068 069 070 071 072 073 073 074 075 076 077 078 079 025 011 067 068 069 070 071 072 073 073 074 075 076 077 078 079 025 011 067 068 069 070 071 072 073 073 074 075 076 077 078 079
000 000 000 000 000 000 000 000 000 000 000 000 000 000 000 000 082 083 084 083 083 085 086 083 083 087 088 083 083 089 083 090 082 083 084 083 083 085 086 083 083 087 088 083 083 089 083 090 082 083 084 083 083 085 086 083 083 087 088 083 083 089 083